2 2 2 2 2 2 2 2 2 2 2 2 2 2 2 2 2 2 2 2
2 2 2 2 2 2 2 2 2 2 2 2 2 2 2 2 2 2 2 2
2 2 2 2 2 2 2 2 2 2 2 2 2 2 2 2 2 2 2 2
2 2 2 2 2 2 2 2 2 2 2 2 2 2 2 2 2 2 2 2
2 2 2 2 2 2 2 2 2 2 2 2 2 2 2 2 2 2 2 2
2 2 2 2 2 2 2 2 2 2 2 2 2 2 2 2 2 2 2 2
2 2 2 2 6 6 6 6 6 6 6 6 6 2 2 2 2 2 2 2
2 2 2 2 6 5 5 5 5 5 5 5 6 2 2 2 2 2 2 2
2 2 2 2 6 5 5 5 5 5 5 5 6 2 2 2 2 2 2 2
2 2 2 2 6 5 5 5 5 5 5 5 6 2 2 2 2 2 2 2
2 2 2 2 6 5 5 5 5 5 5 5 6 2 2 2 2 2 2 2
2 2 2 2 6 5 5 5 5 5 5 5 6 2 2 2 2 2 2 2
2 2 2 2 6 6 6 6 2 6 6 6 6 2 2 2 2 2 2 2
2 2 2 2 2 2 2 2 2 2 2 2 2 2 2 2 2 2 2 2
2 2 2 2 2 2 2 2 2 2 2 2 2 2 2 2 2 2 2 2
2 2 2 2 2 2 2 2 2 2 2 2 2 2 2 2 2 2 2 2
2 2 2 2 2 2 2 2 2 2 2 2 2 2 2 2 2 2 2 2
2 2 2 2 2 2 2 2 2 2 2 2 2 2 2 2 2 2 2 2
2 2 2 2 2 2 2 2 2 2 2 2 2 2 2 2 2 2 2 2